####################
#@...$...#....$...#
#...#....#...#..B.#
#...#..P.#...#..$ #
#..$#..##.#..##...#
#....###..$..#..#.#
#....#..>...#....D#
#....#.....#..^...#
#....#..$..#..#...#
#.....[.......#...#
#.E..##..$..##....#
#....#.....#......#
#...##..P..##..###.
#..$.#....#..$.#..#
#...#...{.#...##..#
#...#########.....#
#....#...$......$.#
#@...#..p..#..B...#
#....$.....#....@.#
####################