##########################
#@.......................#
#......P.........$.......#
#........................#
#...$.........<..........#
#........^...............#
#........................#
#.E......................#
#.........$..............#
#........................#
#.$...........]..........#
#........................#
#........F.........D.....#
#........................#
#........................#
#........................#
#........................#
#........................#
##########################

