####################
#@......#........D#
#.......#.........#
#..$$$..#..$$$....#
#.......#.........#
#.......#.........#
#..$$$..#..$$$....#
#.......#.........#
#.......#.........#
#..$$$..#..$$$....#
#.......#.........#
#.......#.........#
#..$$$..#..$$$....#
#.......#.........#
#.......#.........#
#..$$$..#..$$$....#
#.......#.........#
#.......#.........#
#..$$$..#..$$$....#
#................D#
####################