####################
#@..FGC#.....#....D#
#..$$$..FGC..FGC..$.$#
#......#.....#..$...#
####T##.....####...#
#......#####E......@#
#..$........C... ....#
#......##G###......@#
#######.....F####...#
#......#....T#..$...#
#..$...#..$..#..$.$#
#......#.....#....D#
####################