####################
#@..EEE#.....#....D#
#..$$$..EEE..EEE..$.$#
#......#.....#..$...#
####E##.....####...#
#......#####E......@#
#..$........E... ....#
#......##E###......@#
#######.....E####...#
#......#....E#..$...#
#..$...#..$..#..$.$#
#......#.....#....D#
####################