####################
#@..EF..#....#....D#
#..$$$..E.....F..$.$#
#......#.....#..$...#
####EF##.....####...#
#......#####E......@#
#..$........F... ....#
#......##E###......@#
#######.....F####...#
#......#....E#..$...#
#..$...#..$..#..$.$#
#......#.....#....D#
####################