####################
#@..CTE#.....#....D#
#..$$$..CTE..CTE..$.$#
#......#.....#..$...#
####C##.....####...#
#......#####T......@#
#..$........E... ....#
#......##C###......@#
#######.....T####...#
#......#....E#..$...#
#..$...#..$..#..$.$#
#......#.....#....D#
####################