####################
#@..EFT#.....#....D#
#..$$$..EFT..EFT..$.$#
#......#.....#..$...#
####C##.....####...#
#......#####G......@#
#..$........F... ....#
#......##T###......@#
#######.....E####...#
#......#....C#..$...#
#..$...#..$..#..$.$#
#......#.....#....D#
####################