####################
#@..EFG#.....#....D#
#..$$$..CTE..FGC..$.$#
#......#.....#..$...#
####F##.....####...#
#......#####T......@#
#..$........G... ....#
#......##E###......@#
#######.....C####...#
#......#....F#..$...#
#..$...#..$..#..$.$#
#......#.....#....D#
####################