####################
#@.TT..#.....#....D#
#..$$$..T.....T..$.$#
#......#.....#..$...#
####T##......####...#
#......######......@#
#..$........T... ....#
#......######......@#
#######......####...#
#......#....T#..$...#
#..$...#..$..#..$.$#
#......#.....#....D#
####################