####################
#@..EG..#....#....D#
#..$$$..G.....E..$.$#
#......#.....#..$...#
####EG##.....####...#
#......#####G......@#
#..$........E... ....#
#......##G###......@#
#######.....E####...#
#......#....G#..$...#
#..$...#..$..#..$.$#
#......#.....#....D#
####################