####################
#@..G..#.....#....D#
#..$$$..G.....G..$.$#
#......#.....#..$...#
####G##......####...#
#......######......@#
#..$........G... ....#
#......######......@#
#######......####...#
#......#....G#..$...#
#..$...#..$..#..$.$#
#......#.....#....D#
####################