####################
#@..EE.#.....#....D#
#..$$$..E.....E..$.$#
#......#.....#..$...#
####E##......####...#
#......######......@#
#..$........E... ....#
#......######......@#
#######......####...#
#......#....E#..$...#
#..$...#..$..#..$.$#
#......#.....#....D#
####################