####################
#@..EFG.#....#....D#
#..$$$..E.....F..$.$#
#......#.....#..$...#
####EFG##....####...#
#......#####G......@#
#..$........E... ....#
#......##F###......@#
#######.....G####...#
#......#....E#..$...#
#..$...#..$..#..$.$#
#......#.....#....D#
####################