####################
#@..$$$#.....#....D#
#..$$$..$$$..$$..$$$#
#......#.....#..$...#
####$$##.....####...#
#......#####$......@#
#..$........$... ....#
#......##$$$#......@#
#######.....$$##...#
#......#....$#..$...#
#..$...#..$..#..$.$#
#......#.....#....D#
####################