####################
#@..FG..#....#....D#
#..$$$..F.....G..$.$#
#......#.....#..$...#
####FG##.....####...#
#......#####F......@#
#..$........G... ....#
#......##F###......@#
#######.....G####...#
#......#....F#..$...#
#..$...#..$..#..$.$#
#......#.....#....D#
####################