####################
#@..C..#.....#....D#
#..$$$..C.....C..$.$#
#......#.....#..$...#
####C##......####...#
#......######......@#
#..$........C... ....#
#......######......@#
#######......####...#
#......#....C#..$...#
#..$...#..$..#..$.$#
#......#.....#....D#
####################