#############################
#@..........................#
#...........................#
#..$..$..$..$..$..$..$..$..$#
#...T...T...T...T...T...T...#
#...........................#
#..$..$..$..$..$..$..$..$..$#
#...........................#
#...T...T...T...T...T...T...#
#..$..$..$..$..$..$..$..$..$#
#...........................#
#...........................#
#..$T.$.T$..$..$T.$.T$..$..$#
#...........................#
#.............C.............#
#..$..$..$..$..$..$..$..$..$#
#...T...T...T...T...T...T...#
#...........................#
#..$..$..$..$..$..$..$..$..$#
#...........................#
#...T...T...T...T...T...T...#
#..$..$..$..$..$..$..$..$..$#
#...........................#
#...........................#
#..$T.$.T$..$..$T.$.T$..$..$#
#...........................#
#...........................#
#..$..$..$..$..$..$..$..$..D#
#############################
