######################
#@...................#
#....................#
#..$..$..$..$..$..$..#
#....................#
#....................#
#..$..$..$..$..$..$..#
#....................#
#....................#
#..$..$..$..$..$..$..#
#....................#
#..........C.........#
#..$..$..$..$..$..$..#
#....................#
#....................#
#..$..$..$..$..$..$..#
#....................#
#....................#
#..$..$..$..$..$..$..#
#....................#
#...................D#
######################
