#####################
#@..................#
#...................#
#...................#
#...................#
#...................#
#...................#
#...................#
#...................#
#...................#
#.........C.........#
#...................#
#...................#
#...................#
#...................#
#...................#
#...................#
#...................#
#...................#
#..................D#
#####################
