#######################
#@....................#
#.....................#
#..$..$..$..$..$..$..$#
#.....................#
#.....................#
#..$..$..$..$..$..$..$#
#.....................#
#.....................#
#..$..$..$..$..$..$..$#
#.....................#
#..........C..........#
#..$..$..$..$..$..$..$#
#.....................#
#.....................#
#..$..$..$..$..$..$..$#
#.....................#
#.....................#
#..$..$..$..$..$..$..$#
#.....................#
#.....................#
#..$..$..$..$..$..$..D#
#######################
