###############################
#@............................#
#.............................#
#..$..$..$..$..$..$..$..$..$..#
#...T...T...T...T...T...T...T.#
#.............................#
#..$..$..$..$..$..$..$..$..$..#
#.............................#
#...T...T...T...T...T...T...T.#
#..$..$..$..$..$..$..$..$..$..#
#.............................#
#.............................#
#..$T.$.T$..$..$T.$.T$..$..$T.#
#.............................#
#.............................#
#..$..$..$..$..$..$..$..$..$..#
#...T...T...T...T...T...T...T.#
#.............................#
#..$..$..$..$..$..$..$..$..$..#
#.............................#
#...T...T...T...T...T...T...T.#
#..$..$..$..$..$..$..$..$..$..#
#.............................#
#.............................#
#..$T.$.T$..$..$T.$.T$..$..$T.#
#.............................#
#.............................#
#..$..$..$..$..$..$..$..$..$..#
#...T...T...T...T...T...T...T.#
#............................D#
###############################
